12 12
3 3
-1 -1 -1 -1 -1 -1  2  1  2 -1 -1 -1
-1 -1 -1  2  4 -1  3  2  3 -1  4  2
-1 -1 -1  1  1  6  1  1  1  6  1  1
-1  2  2 -1 -1 -1 -1 -1 -1 -1 -1 -1
-1  4  4 -1 -1 -1 -1 -1 -1 -1 -1 -1
-1 -1  9 -1 -1 -1 -1 -1 -1 -1 -1 -1
-1  2  2 -1 -1 -1 -1 -1 -1 -1 -1 -1
-1  2  2 -1 -1 -1 -1 -1 -1 -1 -1 -1
-1 -1  5 -1 -1 -1 -1 -1 -1 -1 -1 -1
-1 -1  3 -1 -1 -1 -1 -1 -1 -1 -1 -1
-1  2  2 -1 -1 -1 -1 -1 -1 -1 -1 -1
-1 -1  3 -1 -1 -1 -1 -1 -1 -1 -1 -1


result:
0 1 1 0 0 0 1 1 0
1 1 1 1 0 1 1 1 1
1 1 1 1 1 1 1 1 1
0 1 1 0 0 0 1 1 0
0 0 1 1 0 1 1 0 0
0 0 1 1 1 1 1 0 0
0 0 0 1 1 1 0 0 0
1 1 0 0 0 0 0 1 1
0 0 0 1 1 1 0 0 0
