14 14
2 2
-1 -1 -1  2  1  1  2  3  4  5  5 -1 -1 -1
-1 -1  5  1  2  2  2  2  2  2  1  5  5  5
-1  8 -1 -1 -1 -1 -1 -1 -1 -1 -1 -1 -1 -1
 2  5 -1 -1 -1 -1 -1 -1 -1 -1 -1 -1 -1 -1
 1  5 -1 -1 -1 -1 -1 -1 -1 -1 -1 -1 -1 -1
 1  5 -1 -1 -1 -1 -1 -1 -1 -1 -1 -1 -1 -1
 1  5 -1 -1 -1 -1 -1 -1 -1 -1 -1 -1 -1 -1
 2  4 -1 -1 -1 -1 -1 -1 -1 -1 -1 -1 -1 -1
 2  3 -1 -1 -1 -1 -1 -1 -1 -1 -1 -1 -1 -1
 2  2 -1 -1 -1 -1 -1 -1 -1 -1 -1 -1 -1 -1
 2  1 -1 -1 -1 -1 -1 -1 -1 -1 -1 -1 -1 -1
-1  2 -1 -1 -1 -1 -1 -1 -1 -1 -1 -1 -1 -1
-1  2 -1 -1 -1 -1 -1 -1 -1 -1 -1 -1 -1 -1
-1  2 -1 -1 -1 -1 -1 -1 -1 -1 -1 -1 -1 -1

result:
1 1 1 1 1 1 1 1 0 0 0 0
1 1 0 0 1 1 1 1 1 0 0 0
1 0 0 0 0 1 1 1 1 1 0 0
1 0 0 0 0 0 1 1 1 1 1 0
1 0 0 0 0 0 0 1 1 1 1 1
0 1 1 0 0 0 0 0 1 1 1 1
0 0 1 1 0 0 0 0 0 1 1 1
0 0 0 1 1 0 0 0 0 0 1 1
0 0 0 0 1 1 0 0 0 0 0 1
0 0 0 0 0 1 1 0 0 0 0 0
0 0 0 0 0 0 1 1 0 0 0 0
0 0 0 0 0 0 0 1 1 0 0 0