7 8
2 3
-1 -1 -1 -1 -1  3 -1 -1
-1 -1 -1  2  4  1  4  2
 1  1  1 -1 -1 -1 -1 -1
-1 -1  5 -1 -1 -1 -1 -1
-1 -1  3 -1 -1 -1 -1 -1
-1  1  1 -1 -1 -1 -1 -1
-1 -1  3 -1 -1 -1 -1 -1 

result:
1 0 1 0 1
1 1 1 1 1
0 1 1 1 0
0 1 0 1 0
0 1 1 1 0
