12 13
3 4
-1 -1 -1 -1  1  1  1  1  1  1  1  1  1
-1 -1 -1 -1  1  1  1  1  1  1  1  1  1
-1 -1 -1 -1  1  1  1  1  1  1  1  1  1
-1 -1  2  2 -1 -1 -1 -1 -1 -1 -1 -1 -1
 1  1  1  1 -1 -1 -1 -1 -1 -1 -1 -1 -1
-1  1  1  1 -1 -1 -1 -1 -1 -1 -1 -1 -1
 1  1  1  1 -1 -1 -1 -1 -1 -1 -1 -1 -1
-1 -1  1  1 -1 -1 -1 -1 -1 -1 -1 -1 -1
-1  1  1  1 -1 -1 -1 -1 -1 -1 -1 -1 -1
-1 -1  1  1 -1 -1 -1 -1 -1 -1 -1 -1 -1
-1 -1  1  1 -1 -1 -1 -1 -1 -1 -1 -1 -1
-1 -1 -1  3 -1 -1 -1 -1 -1 -1 -1 -1 -1


result:
0 1 1 0 0 0 1 1 0
1 0 0 1 0 1 0 0 1
0 1 0 0 1 0 0 1 0
1 0 1 0 0 0 1 0 1
0 0 0 1 0 1 0 0 0
1 0 0 0 1 0 0 0 1
0 1 0 0 0 0 0 1 0
0 0 1 0 0 0 1 0 0
0 0 0 1 1 1 0 0 0